//MAP CONVERTED BY dmm2tgm.py THIS HEADER COMMENT PREVENTS RECONVERSION, DO NOT REMOVE
"a" = (
/turf/open/floor/plasteel/tech,
/area/centcom/evac)
"c" = (
/obj/structure/chair/fancy/shuttle{
	dir = 4
	},
/obj/machinery/light{
	dir = 8;
	light_color = "#e8eaff"
	},
/turf/open/floor/plasteel/tech/grid,
/area/centcom/evac)
"d" = (
/obj/machinery/door/airlock/hatch,
/turf/open/floor/plasteel/tech,
/area/centcom/evac)
"h" = (
/obj/effect/turf_decal/techfloor{
	dir = 8
	},
/obj/item/storage/backpack/duffelbag/syndie/c20rbundle,
/turf/open/floor/plasteel/tech,
/area/centcom/evac)
"j" = (
/obj/effect/turf_decal/techfloor{
	dir = 8
	},
/obj/item/storage/backpack/duffelbag/syndie/bulldogbundle,
/turf/open/floor/plasteel/tech,
/area/centcom/evac)
"n" = (
/obj/effect/turf_decal/techfloor{
	dir = 4
	},
/obj/item/clothing/under/costume/mech_suit/white,
/obj/item/gun/ballistic/automatic/pistol/APS,
/turf/open/floor/plasteel/tech,
/area/centcom/evac)
"o" = (
/turf/closed/wall/mineral/plastitanium,
/area/centcom/evac)
"p" = (
/obj/structure/chair/fancy/shuttle{
	dir = 8
	},
/turf/open/floor/plasteel/tech/grid,
/area/centcom/evac)
"r" = (
/obj/effect/turf_decal/techfloor{
	dir = 4
	},
/turf/open/floor/plasteel/tech,
/area/centcom/evac)
"s" = (
/obj/mecha/combat/marauder/mauler/loaded,
/turf/open/floor/mech_bay_recharge_floor,
/area/centcom/evac)
"t" = (
/obj/structure/chair/fancy/shuttle{
	dir = 8
	},
/obj/machinery/light{
	dir = 4
	},
/turf/open/floor/plasteel/tech/grid,
/area/centcom/evac)
"v" = (
/obj/machinery/mech_bay_recharge_port,
/obj/machinery/light,
/turf/open/floor/plating,
/area/centcom/evac)
"z" = (
/obj/effect/turf_decal/techfloor{
	dir = 4
	},
/obj/item/gun/ballistic/automatic/m90,
/obj/item/ammo_box/magazine/m556,
/obj/item/ammo_box/magazine/m556,
/obj/item/ammo_box/magazine/m556,
/turf/open/floor/plasteel/tech,
/area/centcom/evac)
"C" = (
/turf/closed/wall/mineral/plastitanium/nodiagonal,
/area/centcom/evac)
"D" = (
/obj/structure/chair/fancy/shuttle{
	dir = 4
	},
/turf/open/floor/plasteel/tech/grid,
/area/centcom/evac)
"G" = (
/obj/machinery/computer/mech_bay_power_console{
	dir = 1
	},
/obj/machinery/light,
/turf/open/floor/pod/light,
/area/centcom/evac)
"J" = (
/turf/template_noop,
/area/template_noop)
"X" = (
/obj/effect/turf_decal/techfloor{
	dir = 8
	},
/turf/open/floor/plasteel/tech,
/area/centcom/evac)

(1,1,1) = {"
J
o
C
C
C
o
J
"}
(2,1,1) = {"
C
C
c
D
c
C
C
"}
(3,1,1) = {"
v
C
j
X
h
X
C
"}
(4,1,1) = {"
s
d
a
a
a
a
d
"}
(5,1,1) = {"
G
C
n
r
z
r
C
"}
(6,1,1) = {"
C
C
t
p
t
C
C
"}
(7,1,1) = {"
J
o
C
C
C
o
J
"}
