//MAP CONVERTED BY dmm2tgm.py THIS HEADER COMMENT PREVENTS RECONVERSION, DO NOT REMOVE
"a" = (
/turf/open/floor/black,
/area/space)
"b" = (
/obj/item/storage/backpack/security,
/turf/open/floor/black,
/area/space)
"e" = (
/obj/item/clothing/suit/armor/vest/blueshirt,
/turf/open/floor/black,
/area/space)
"h" = (
/obj/item/clothing/head/beret/corpsec,
/turf/open/floor/black,
/area/space)
"l" = (
/obj/item/clothing/head/beret/ccguardnavy,
/turf/open/floor/black,
/area/space)
"m" = (
/obj/item/clothing/under/syndicate/combat,
/turf/open/floor/black,
/area/space)
"n" = (
/obj/item/clothing/head/beret/ccguard,
/turf/open/floor/black,
/area/space)
"o" = (
/obj/item/clothing/suit/armor/vest/leather,
/turf/open/floor/black,
/area/space)
"p" = (
/obj/item/clothing/suit/armor/vest/warden,
/turf/open/floor/black,
/area/space)
"q" = (
/obj/item/radio/headset/headset_sec,
/turf/open/floor/black,
/area/space)
"u" = (
/obj/item/gun/ballistic/automatic/pistol/m1911,
/turf/open/floor/black,
/area/space)
"v" = (
/obj/item/melee/classic_baton/police/telescopic,
/turf/open/floor/black,
/area/space)
"B" = (
/obj/item/gun/energy/disabler{
	pixel_y = 1
	},
/turf/open/floor/black,
/area/space)
"C" = (
/obj/item/clothing/suit/armor/bulletproof,
/turf/open/floor/black,
/area/space)
"I" = (
/obj/item/clothing/head/beret/corpwarden,
/turf/open/floor/black,
/area/space)
"P" = (
/obj/item/storage/belt/military,
/turf/open/floor/black,
/area/space)
"Q" = (
/obj/item/gun/ballistic/automatic/wt550,
/turf/open/floor/black,
/area/space)
"T" = (
/obj/item/clothing/head/helmet/alt,
/turf/open/floor/black,
/area/space)
"U" = (
/obj/item/clothing/shoes/combat,
/turf/open/floor/black,
/area/space)
"W" = (
/obj/item/clothing/head/helmet/riot,
/turf/open/floor/black,
/area/space)
"X" = (
/obj/item/clothing/gloves/combat,
/turf/open/floor/black,
/area/space)
"Z" = (
/obj/item/clothing/glasses/hud/security/sunglasses,
/turf/open/floor/black,
/area/space)

(1,1,1) = {"
I
v
p
o
e
a
"}
(2,1,1) = {"
h
T
C
q
q
a
"}
(3,1,1) = {"
B
W
b
U
Z
X
"}
(4,1,1) = {"
u
l
b
U
Z
X
"}
(5,1,1) = {"
Q
n
m
m
P
P
"}
