//MAP CONVERTED BY dmm2tgm.py THIS HEADER COMMENT PREVENTS RECONVERSION, DO NOT REMOVE
"a" = (
/turf/open/floor/bamboo,
/area/space)
"d" = (
/obj/item/clothing/head/beret/ccguardnavy,
/turf/open/floor/black,
/area/space)
"e" = (
/turf/open/floor/black,
/area/space)
"j" = (
/obj/item/clothing/glasses/hud/diagnostic,
/turf/open/floor/black,
/area/space)
"k" = (
/obj/item/clothing/glasses/hud/security/sunglasses,
/turf/open/floor/black,
/area/space)
"l" = (
/obj/item/clothing/suit/armor/vest/leather{
	desc = "Lightly armored leather overcoat meant as casual wear for high-ranking officers. Bears the crest of Nanotrasen Security."s
	},
/turf/open/floor/black,
/area/space)
"n" = (
/obj/item/clothing/head/helmet/riot,
/turf/open/floor/black,
/area/space)
"o" = (
/obj/effect/decal/cleanable/ash/large,
/turf/open/floor/bamboo,
/area/space)
"p" = (
/obj/item/clothing/suit/armor/vest/warden,
/turf/open/floor/black,
/area/space)
"r" = (
/obj/item/clothing/suit/armor/bulletproof,
/turf/open/floor/black,
/area/space)
"s" = (
/obj/item/clothing/suit/armor/vest/blueshirt,
/turf/open/floor/black,
/area/space)
"u" = (
/obj/effect/decal/cleanable/robot_debris,
/turf/open/floor/bamboo,
/area/space)
"x" = (
/obj/item/clothing/gloves/color/black,
/turf/open/floor/black,
/area/space)
"y" = (
/obj/item/clothing/head/beret/corpwarden,
/turf/open/floor/black,
/area/space)
"z" = (
/obj/effect/decal/cleanable/blood,
/turf/open/floor/bamboo,
/area/space)
"E" = (
/obj/item/clothing/mask/gas/sechailer/swat/spacepol,
/turf/open/floor/black,
/area/space)
"H" = (
/obj/item/clothing/gloves/combat,
/turf/open/floor/black,
/area/space)
"I" = (
/obj/item/clothing/head/beret/corpsec,
/turf/open/floor/black,
/area/space)
"J" = (
/obj/item/clothing/under/syndicate/combat,
/turf/open/floor/black,
/area/space)
"K" = (
/obj/item/clothing/head/helmet/alt,
/turf/open/floor/black,
/area/space)
"N" = (
/obj/item/clothing/glasses/hud/diagnostic/sunglasses,
/turf/open/floor/black,
/area/space)
"O" = (
/obj/item/clothing/gloves/fingerless,
/turf/open/floor/black,
/area/space)
"P" = (
/obj/item/clothing/shoes/combat,
/turf/open/floor/black,
/area/space)
"Q" = (
/obj/item/melee/classic_baton/police/telescopic,
/turf/open/floor/black,
/area/space)
"R" = (
/obj/item/storage/belt/military,
/turf/open/floor/black,
/area/space)
"V" = (
/obj/item/storage/backpack/security,
/turf/open/floor/black,
/area/space)
"X" = (
/obj/item/radio/headset/headset_sec,
/turf/open/floor/black,
/area/space)
"Y" = (
/obj/item/clothing/under/pants/khaki,
/turf/open/floor/black,
/area/space)
"Z" = (
/obj/item/clothing/mask/gas/sechailer,
/turf/open/floor/black,
/area/space)

(1,1,1) = {"
a
a
a
a
a
a
a
a
"}
(2,1,1) = {"
z
y
Z
l
e
e
e
a
"}
(3,1,1) = {"
z
X
N
Y
H
Q
e
a
"}
(4,1,1) = {"
z
e
j
J
O
e
e
a
"}
(5,1,1) = {"
a
a
a
a
a
a
a
a
"}
(6,1,1) = {"
o
n
I
s
R
P
e
a
"}
(7,1,1) = {"
o
k
K
r
x
V
e
a
"}
(8,1,1) = {"
o
X
Z
J
e
e
e
a
"}
(9,1,1) = {"
a
a
a
a
a
a
a
a
"}
(10,1,1) = {"
u
d
E
p
R
P
V
a
"}
(11,1,1) = {"
u
X
k
J
H
Q
e
a
"}
(12,1,1) = {"
a
a
a
a
a
a
a
a
"}
